0:0:000:000:src/images/light_grass.png
1:0:000:000:src/images/rock2.png
2:0:000:000:src/images/sand.png
3:1:000:040:src/images/grass_wall.png
4:1:000:000:src/images/grass_wall.png
 
030000000000000000000000000000000000000000000000000000000004
300000001111111111111111111111111111111111111111000000000004
400000001111111111111111111111111111111111111111000000000004
400000001111111111111111111111111111111111111111000000000004
400000001111111111111111111111111111111111111111000000000004
400000001111111111111111111111111111111111111111000000000004
400000001111111111111111111111111111111111111111000000000004
400000001111111111111111111111111111111111111111000000000004
400000001111111111111111111111111111111111111111000000000004
400000001111111111111111111111111111111111111111000000000004
400000000000000000000000000000000000000000000000000000000004
400000000000000000000000000000000000000000000000000000000004
400000000000000000000000000000000000000000000000000000000004
400000000000000000000000000000000000000000000000000000000004
400000000000000000000000000000000000000000000000000000000004
400000000000000000000000000000000000000000000000000000000004
400000000000000000000000000000000000000000000000000000000004
400000000000000000000000000000000000000000000000000000000004
400000000000000000000000000000000000000000000000000000000004
400000000000000000000000000000000000000000000000000000000004
400000000000000000000000000000000000000000000000000000000004
400000000000000000000000000000000000000000000000000000000004
400000000000000000000000000000000000000000000000000000000004
400000000000000000000000000000000000000000000000000000000004
400000000000000000000000000000000000000000000000000000000004
400000000000000000000000000000000000000000000000000000000004
400000000000000000000000000000000000000000000000000000000004
400000000000000000000000000000000000000000000000000000000004
400000000000000000000000000000000000000000000000000000000004
400000000000000000000000000000000000000000000000000000000004
400000000000000000000000000000000000000000000000000000000004
400000000000000000000000000000000000000000000000000000000004
400000000000000000000000000000000000000000000000000000000004
400000000000000000000000000000000000000000000000000000000004
400000000000000000000000000000000000000000000000000000000004
400000000000000000000000000000000000000000000000000000000004
400000000000000000000000000000000000000000000000000000000004
400000000000000000000000000000000000000000000000000000000004
400000000000000000000000000000000000000000000000000000000004
400000000000000000000000000000000000000000000000000000000004
444444444444444444444444444444444444444444444444444444444444
 
0:0:000:000:src/images/none.png
1:1:-15:020:src/images/tree.png
 
001111111111111111111111111111111111111111111111111111111111
010000000000000000000000000000000000000000000000000000000001
100000000100000000000000000000000000000000000000000000000001
1000000000001110000000000000000000000000000000000000000000001
100000000000101000000000000000000000000000000000000000000001
100000000111101000000000000000000000000000000000000000000001
100000000000001000000000000000000000000000000000000000000001
100000001111101000000000000000000000000000000000000000000001
100000000000000000000000000000000000000000000000000000000001
100000000000000000000000000000000000000000000000000000000001
100000000000000000000000000010000000000000000000000000000001
100000000000000000000000000000000000000000000000000000000001
100000000000000000000000000000000000000000000000000000000001
100000000000000000000000000000000000000000000000000000000001
100000000000000000000000000000000000000000000000000000000001
100000000000000000000000000000000000000000000000000000000001
100000000000000000000000000000000000000000000000000000000001
100000000000000000000000000000000000000000000000000000000001
100000000000000000000000000000000000000000000000000000000001
100000000000000000000000000000000000000000000000000000000001
100000000000000000000000000000000000000000000000000000000001
100000000000000000000000000011000000000000000000000000000001
100000000000000000000000000011000000000000000000000000000001
100000000000000000000000000000000000000000000000000000000001
100000000000000000100000000000000000000000000000000000000001
100000000000000000000000000000000000000000000000000000000001
100000000000000000000000000000000000000000000000000000000001
100000000000000000000000000000000000000000000000000000000001
100000000000000000000000000000000000000000000000000000000001
100000000000000000000000000000000000000000000000000000000001
100000000000000000000000000000000000000000000000000000000001
100000000000000000000000000000000000000000000000000000000001
100000000000000000000000000000000000000000000000000000000001
100000000000000000000000000000000000001000000000000000000001
100000000000000000000000000000000000000000000000000000000001
100000000000000000000000000000000000000000000000000000000001
100000000000000000000000000000000000000000000000000000000001
110000000000000000000000000000000000000000000000000000000001
100000000000000000000000000000000000000000000000000000000001
100000000000000000000000000000000000000000000000000000000001
111111111111111111111111111111111111111111111111111111111111