0:0:000:000:src/images/light_grass.png
1:0:000:000:src/images/rock2.png
2:0:000:000:src/images/sand.png
3:1:000:040:src/images/grass_wall.png
4:1:000:000:src/images/grass_wall.png
 
111111111111111111111111111111111111111111111111111111111111111111111111111111111111111111111111111111
101001010001000000000101000000100000110010101000001100000001000011000001011000010001100000001010001001
100100010101010111010100011010010110001000000110100001101100101000010101000011000100010110110000100101
101001010101001001010001101010100111100111010001001101001010010101010100101000101011010010000101110101
100100100101100101010101000100001010010100011100100010010011000010010010011111001000001001011001110101
110110010100110101001010010011110000100101100010011001011001101001100101001000101010110100111010100101
110001000010000101010001001000011010101000001001011101000100010010001000100010100100000010010010001001
101101101001011001010100010111000100100111100101001001110011010100101010011100110011111011010111010011
100100010101000101000111100000110010010000011001101010001001000110011001010001001010001001010010001001
101011010000101000111000010110010100101101010010001010101010011011000010010110100011011010001001101101
101001011010010010100011011000110010000011000101010100100010110000011110110010001001010010101101000001
100100000101000100010101000010001010111000111001000010110100001011100000101010100101001011000100110101
110010110100111011000100101101010010100110001010111010001011100100010111101001001100100000110010010101
101001010010001000111001000100010100110010100000001001101000010001000100001101010010111010011101001001
100100001010101010100101010011100010001001011011010100001011001110111001100101011010000101000001010011
101001100010110010010001010100011010100100000001100010110000101000000100101001000001010000111101001001
101010101100000101000100001001000010010010111100001101000111000011010001000100111101100101000000100101
101010011011101100101010101010111101001010000101111000011000101110011010010010100100101010011111001001
101001000000010001000001010010100000111001010010000011011010010001000110101010010110101000100000011011
101010010111000101111010000100001010000101001100111100100011000100110001000001010000101011001011100001
101010110001011100000100111010110111110100100101000101001100011010100100111101001010101010010100010101
101010001100100011010001100000010010000001001001010001010101100010011010000100101001001000100001001001
101001101110001000101110001111001000111010010011001101010001001000100001010011001011010111001010100011
100100100101100101000010110000100111000100101000100101001110011111001101001010010100010000011000011101
101001010100011001011011110110010100010011001110010010010001001000010001111010110001100111110011000001
100101000110100010001000100100100101101000100011001001010100101110110110000010100101001000001001110101
110001010000101100100110001010001101000110101000101101000110100000100100111100101001010010100110001001
100111010111001010010001101000110001110010100110100100101000110101010010100001000100100100110100100101
110100001000010001010110010011000110000100010010010110010011001010001010101100101010001101010001010011
100011101011100101010001000110011000110011001001010001010100010001101000100011001001110000001110001001
101100010010101101001100101000100011001000100101001101010011000100001101011000100100001011111000100101
100001000100011000101110011101101100100110010001010101011001010011010000001010101001100100000011010101
111110111001000010100111001001001001010011001110000101000100101001000111100100100010010101011101010101
100010000101011001010011010010010100001000101010111001101010001100101000101001111110100100100100010101
101010110001100010000100010100100101101010001010000010101010100011011010010010100000101010110010100101
100100111010001110101101010101010000100011110001011100000010110100000010100100010101100010001000101001
110001010001011000010001100101000101111100010100100001011010001001111010001001000100011001100101000101
100110001100100011010100101001111000100010100010101010100001010010000101111010011011001101010100010001
110010100010101100100011100100000110101010001010100100010110001001010100000100100000100101010101001101
101001001010100101101100001001010100110001011100110101010010100100010110110010010110010100010010100101
100101011010101001000101110101100101000101001001000101000110010010110000101001000011110010101010110011
101001100010100010011001010000101000011000100100111001110001001001001111000100101100001000001010001001
100100101010011010110010000111001111100010010010000010011100100100100000101010110001100111101001010101
101010101010101010000101101000100000011111010101110100100001101001001110000010000110010100011010010101
100010100100101001111000011010011011000010000100001001001110001011010001110101101101010101000011000101
101100010101000100000011000011000100011001101001100100010000101100001010000100010001010001110100010001
100010100100010111111110110101110010111100010100010101001010010001110001010011000110001110001001101101
101010001001110000000000001000001010111111010010100100101010100110000101001010101100110001011010100011
101001100110001011101111100101101010011100011000101110010010101000110010101000101001100100000010001001
100100110000100100001000001000100011001001101010101110100101001010101100101101000010001011110100110101
101110001111010101010011110010011100111010000001100100101000010011000001100101011100110000001010100001
100101010000010100111010010100100010000001111100010001100110110100011011010101000101000110100000101111
110101001101010110110000100101001001010110000111100110001000100101101000010100110101010001010110101001
110000100001010010001110101010010100001000110000011000101011001001000110100010010100101100001000100101
101101110101001001100001101000100010100010001111010011110011100010010010101001000010100110100110010101
101100110010010100010100001011011001011110101001001000100101111111001000100100101110010001101000100001
100010001001100001101010110010000010000001001011100110001000100011010101110010010000100100001010011111
101010100101001110000001001010101010110101100001001001110010001000010000100101010111001001110010100001
101010010101011000111100101010101010111000011010010101000100110101001010101001010000100100001001001101
101001001001010010000010001001001010010011001001000001011001000010010011001101011110110011110011010001
100100010010011110101010100101010011010100100111101101001010011001100101010000000010011100001010010101
101010100100100001001001110101001001001001010001001010101000101101001001001110111011000101100010100111
110001001001001101100100100100010011100100001100010000101111100101010100100001001000110100011100110001
100101011010011100010010101011100101010010100011010110000000010101000010011100100101010011000001001101
101000010010101011001010100000010100001001101001010001011101000100111000100010010100001001010110101001
100110100110100000101010011010100010100100000101011010100010011001001110001100100111101100110010001011
110111101000010101000111000110011000010011110101001000101001001010100000110001010000000110101000101001
100010001011110010010010010101000110111100001001100101001101010010101110010110001010110010100101001011
101000110010001000101001110100101010010001100010101001010101001000010001100000100100101010010001110001
101101010100100101000101000110100001010110011010001010010000100111010100011111010101100101011010000101
100011000101110010101001011000010101010001000100110011011010011100010011000000010100010001000100101001
111000101000111010001010010011001001001101010101100101000101000001011000101101000111001010110110110101
100110100010011001100000101100101010100100010101001000110100101010000110010000101001010000110010000011
110010011001000100111011000001100000010011100010010101010110010011101001001011010100000110001010111011
100101000111010110000100010100010101001000010100100000010001000100010010100100000101111001010010001001
101000110000110001110001101011001110010011100010010111001100101001000100010001110010000010010100100101
100010001010100110011111000000100100110100001101010101010101001010010001011100010100101010100101001001
110110101100110001000000110110010101100101110001000101010100110010101100100011010001010001010010010011
110100110001001101011010001000110010001000000101111000010110000110000010101000100110000110001001010111
100110010111010001010011101010001000110101010100000101100001111001011001100110011110111000100101010111
101000110100001010010100001010101111100010101001010101011100001101100100010001000100100011010001010011
101101000101110011100010100011010000001010000101110000000101110000001010101101010001001110001101011001
100010011000000100011011001100000110110011010010001111010100000110100010000100101010010000100010000101
101000100101111001001000110001010101000100001010101000100011011010011011011010000110101010101000111101
100111010100000100101110010110001000101001011000101010111000100001010001000001110000100100010111000001
101000000011010001100000100010110010101110010111001010000110010100010101110101001111010011000001010101
101101011000101101001011101010100110100010100100101011010011000010100010000100100000001001111101001011
100010001110000110010100010010101100111000010001001001111000111111001010111001111110100100000000100001
111011010001110000100001001001001001000110100100101100011010000010010100101010100000110010110110011101
101000110100001101001010010100010010010001001010100011000110111001000101001010001111001001100101010001
100110100011101000110010100101100110100110011000011010010001000100111001010011010000100101001001100101
101000101100101011000100101100010100101000100010100010100101010001000011010100010110001001100010001101
100011001001100100011101001011010010100101010100010100101000100111011100010101100101100010011010110001
101100010011010011010001100010001010110110001001000010010011001000010001010100110000010111000010001111
100101100100001000010110101000101000010000101010011001010100011011010100100110001111001010010100110001
110101001101100101100100100111000101101111001101111010100101010011100101101000101000100001101001000101
100100100000110010001010001000110010001000100000010010001010010101001001001110100110111100000100010101
110010101010001001010001111010101000110010110111010100101001000100010100100001010010000011110111001001
100100100111010111010100000010000110010100001000010101000100101001100010011100001001011000010000111011
101101010010100000001101111101110101100101100101100010010110011010001011000011010101010011101110100011
100000001000001010100001000000000000001000010001001000100001000000110000101000000001001000000000001001
111111111111111111111111111111111111111111111111111111111111111111111111111111111111111111111111111111
 
0:0:000:000:src/images/none.png
1:1:-15:020:src/images/tree.png
2:0:200:100:src/images/WASD.png
 
111111111111111111111111111111111111111111111111111111111111111111111111111111111111111111111111111111
120010100010000000001010000001000001100101010000011000000010000110000010110000100011000000010100010001
100100010101010111010100011010010110001000000110100001101100101000010101000011000100010110110000100101
101001010101001001010001101010100111100111010001001101001010010101010100101000101011010010000101110101
100100100101100101010101000100001010010100011100100010010011000010010010011111001000001001011001110101
110110010100110101001010010011110000100101100010011001011001101001100101001000101010110100111010100101
110001000010000101010001001000011010101000001001011101000100010010001000100010100100000010010010001001
101101101001011001010100010111000100100111100101001001110011010100101010011100110011111011010111010011
100100010101000101000111100000110010010000011001101010001001000110011001010001001010001001010010001001
101011010000101000111000010110010100101101010010001010101010011011000010010110100011011010001001101101
101001011010010010100011011000110010000011000101010100100010110000011110110010001001010010101101000001
100100000101000100010101000010001010111000111001000010110100001011100000101010100101001011000100110101
110010110100111011000100101101010010100110001010111010001011100100010111101001001100100000110010010101
101001010010001000111001000100010100110010100000001001101000010001000100001101010010111010011101001001
100100001010101010100101010011100010001001011011010100001011001110111001100101011010000101000001010011
101001100010110010010001010100011010100100000001100010110000101000000100101001000001010000111101001001
101010101100000101000100001001000010010010111100001101000111000011010001000100111101100101000000100101
101010011011101100101010101010111101001010000101111000011000101110011010010010100100101010011111001001
101001000000010001000001010010100000111001010010000011011010010001000110101010010110101000100000011011
101010010111000101111010000100001010000101001100111100100011000100110001000001010000101011001011100001
101010110001011100000100111010110111110100100101000101001100011010100100111101001010101010010100010101
101010001100100011010001100000010010000001001001010001010101100010011010000100101001001000100001001001
101001101110001000101110001111001000111010010011001101010001001000100001010011001011010111001010100011
100100100101100101000010110000100111000100101000100101001110011111001101001010010100010000011000011101
101001010100011001011011110110010100010011001110010010010001001000010001111010110001100111110011000001
100101000110100010001000100100100101101000100011001001010100101110110110000010100101001000001001110101
110001010000101100100110001010001101000110101000101101000110100000100100111100101001010010100110001001
100111010111001010010001101000110001110010100110100100101000110101010010100001000100100100110100100101
110100001000010001010110010011000110000100010010010110010011001010001010101100101010001101010001010011
100011101011100101010001000110011000110011001001010001010100010001101000100011001001110000001110001001
101100010010101101001100101000100011001000100101001101010011000100001101011000100100001011111000100101
100001000100011000101110011101101100100110010001010101011001010011010000001010101001100100000011010101
111110111001000010100111001001001001010011001110000101000100101001000111100100100010010101011101010101
100010000101011001010011010010010100001000101010111001101010001100101000101001111110100100100100010101
101010110001100010000100010100100101101010001010000010101010100011011010010010100000101010110010100101
100100111010001110101101010101010000100011110001011100000010110100000010100100010101100010001000101001
110001010001011000010001100101000101111100010100100001011010001001111010001001000100011001100101000101
100110001100100011010100101001111000100010100010101010100001010010000101111010011011001101010100010001
110010100010101100100011100100000110101010001010100100010110001001010100000100100000100101010101001101
101001001010100101101100001001010100110001011100110101010010100100010110110010010110010100010010100101
100101011010101001000101110101100101000101001001000101000110010010110000101001000011110010101010110011
101001100010100010011001010000101000011000100100111001110001001001001111000100101100001000001010001001
100100101010011010110010000111001111100010010010000010011100100100100000101010110001100111101001010101
101010101010101010000101101000100000011111010101110100100001101001001110000010000110010100011010010101
100010100100101001111000011010011011000010000100001001001110001011010001110101101101010101000011000101
101100010101000100000011000011000100011001101001100100010000101100001010000100010001010001110100010001
100010100100010111111110110101110010111100010100010101001010010001110001010011000110001110001001101101
101010001001110000000000001000001010111111010010100100101010100110000101001010101100110001011010100011
101001100110001011101111100101101010011100011000101110010010101000110010101000101001100100000010001001
100100110000100100001000001000100011001001101010101110100101001010101100101101000010001011110100110101
101110001111010101010011110010011100111010000001100100101000010011000001100101011100110000001010100001
100101010000010100111010010100100010000001111100010001100110110100011011010101000101000110100000101111
110101001101010110110000100101001001010110000111100110001000100101101000010100110101010001010110101001
110000100001010010001110101010010100001000110000011000101011001001000110100010010100101100001000100101
101101110101001001100001101000100010100010001111010011110011100010010010101001000010100110100110010101
101100110010010100010100001011011001011110101001001000100101111111001000100100101110010001101000100001
100010001001100001101010110010000010000001001011100110001000100011010101110010010000100100001010011111
101010100101001110000001001010101010110101100001001001110010001000010000100101010111001001110010100001
101010010101011000111100101010101010111000011010010101000100110101001010101001010000100100001001001101
101001001001010010000010001001001010010011001001000001011001000010010011001101011110110011110011010001
100100010010011110101010100101010011010100100111101101001010011001100101010000000010011100001010010101
101010100100100001001001110101001001001001010001001010101000101101001001001110111011000101100010100111
110001001001001101100100100100010011100100001100010000101111100101010100100001001000110100011100110001
100101011010011100010010101011100101010010100011010110000000010101000010011100100101010011000001001101
101000010010101011001010100000010100001001101001010001011101000100111000100010010100001001010110101001
100110100110100000101010011010100010100100000101011010100010011001001110001100100111101100110010001011
110111101000010101000111000110011000010011110101001000101001001010100000110001010000000110101000101001
100010001011110010010010010101000110111100001001100101001101010010101110010110001010110010100101001011
101000110010001000101001110100101010010001100010101001010101001000010001100000100100101010010001110001
101101010100100101000101000110100001010110011010001010010000100111010100011111010101100101011010000101
100011000101110010101001011000010101010001000100110011011010011100010011000000010100010001000100101001
111000101000111010001010010011001001001101010101100101000101000001011000101101000111001010110110110101
100110100010011001100000101100101010100100010101001000110100101010000110010000101001010000110010000011
110010011001000100111011000001100000010011100010010101010110010011101001001011010100000110001010111011
100101000111010110000100010100010101001000010100100000010001000100010010100100000101111001010010001001
101000110000110001110001101011001110010011100010010111001100101001000100010001110010000010010100100101
100010001010100110011111000000100100110100001101010101010101001010010001011100010100101010100101001001
110110101100110001000000110110010101100101110001000101010100110010101100100011010001010001010010010011
110100110001001101011010001000110010001000000101111000010110000110000010101000100110000110001001010111
100110010111010001010011101010001000110101010100000101100001111001011001100110011110111000100101010111
101000110100001010010100001010101111100010101001010101011100001101100100010001000100100011010001010011
101101000101110011100010100011010000001010000101110000000101110000001010101101010001001110001101011001
100010011000000100011011001100000110110011010010001111010100000110100010000100101010010000100010000101
101000100101111001001000110001010101000100001010101000100011011010011011011010000110101010101000111101
100111010100000100101110010110001000101001011000101010111000100001010001000001110000100100010111000001
101000000011010001100000100010110010101110010111001010000110010100010101110101001111010011000001010101
101101011000101101001011101010100110100010100100101011010011000010100010000100100000001001111101001011
100010001110000110010100010010101100111000010001001001111000111111001010111001111110100100000000100001
111011010001110000100001001001001001000110100100101100011010000010010100101010100000110010110110011101
101000110100001101001010010100010010010001001010100011000110111001000101001010001111001001100101010001
100110100011101000110010100101100110100110011000011010010001000100111001010011010000100101001001100101
101000101100101011000100101100010100101000100010100010100101010001000011010100010110001001100010001101
100011001001100100011101001011010010100101010100010100101000100111011100010101100101100010011010110001
101100010011010011010001100010001010110110001001000010010011001000010001010100110000010111000010001111
100101100100001000010110101000101000010000101010011001010100011011010100100110001111001010010100110001
110101001101100101100100100111000101101111001101111010100101010011100101101000101000100001101001000101
100100100000110010001010001000110010001000100000010010001010010101001001001110100110111100000100010101
110010101010001001010001111010101000110010110111010100101001000100010100100001010010000011110111001001
100100100111010111010100000010000110010100001000010101000100101001100010011100001001011000010000111011
101101010010100000001101111101110101100101100101100010010110011010001011000011010101010011101110100011
100000001000001010100001000000000000001000010001001000100001000000110000101000000001001000000000001001
111111111111111111111111111111111111111111111111111111111111111111111111111111111111111111111111111111